###############
S.....#####.###
###.#.........#
#.#...####.##.#
#...#.#.......#
##.##.####.####
#..#.....#....#
#.######...##.#
#.....######..#
###.#........##
#...#.######..#
#.#.#.....F##.#
#...########..#
###..........##
###############
